NO ./texture/green.xpm
SO ./texture/red.xpm
WE ./texture/grey.xpm
EA ./texture/brown.xpm

F 187,210,225
C 37,253,233

        1111111111111111111111111
        1100000000110000001000001
        1010000011100000010000011
        1001000000000000000000001
111111111111000001110000000000001
100000000011000001110100111111111
10000000000000000000000000001
10000000000000000000000000001
10000001100000111100011000001
10000001100000000000110000001
10000000000000100000000000001
1000000000000000000000000000111
10000000000000000000000000001
11110111110111011100000010001
11110111110111010101010010001
110000001101010111000100100001
10001000000000000000010000001
10000000000000000001010001001
110000011101010111110111100111
11110111 1110101 1011110100N1
11111111 1111111 111111111111
