NO ./texture/green.xpm
SO ./texture/red.xpm
WE ./texture/grey.xpm
EA ./texture/brown.xpm
F 200,200,200
C 250,250,250

1111
1001
1111
