NO ./textures/a.xpm
SO ./textures/b.xpm
WE ./textures/c.xpm
EA ./textures/d.xpm

F 200,200,200
C 250,250,250

     1
    101
 11111111        1  
  100000011111  101
 10000011      1001
1000000111    1011
1111000000111111111
    1N0000000001
111111111111111111
   101
    1
