111111111111111
1P101C0001010E1
100001011000101
110100001010101
101101100010101
100000001C10101
101111101111101
100100000000001
110111111111111
111111111111111
